01 01 01 01 01 01 01 01 01 01 01 01 01 01 01 01 
01 00 00 00 00 00 00 00 00 00 00 00 00 00 00 01
01 00 00 00 00 00 00 00 00 00 00 00 00 00 00 01
01 00 00 00 00 00 00 00 00 00 00 00 00 00 00 01
01 00 00 00 00 00 00 00 00 00 00 00 00 00 00 01
01 00 00 00 00 00 00 00 00 00 00 00 00 00 00 01
01 00 00 00 00 00 00 00 00 00 00 00 00 00 00 19
01 00 00 00 00 00 00 00 00 00 00 00 00 00 00 18
01 00 00 00 00 00 00 00 00 00 00 00 00 00 00 17
01 02 03 04 05 06 07 08 09 10 11 12 13 14 15 16 