01 01 01 01 01 01 01 01 01 01 01 01 01 01 01 01 
01 00 00 00 04 00 00 00 00 01 00 00 00 00 00 01
01 00 00 00 03 00 00 00 00 01 00 02 01 00 00 01
01 00 00 00 02 00 00 00 00 02 00 02 02 00 00 01
01 00 00 00 02 00 00 01 02 03 00 01 03 00 00 01
01 00 00 00 00 00 00 00 00 00 00 01 01 00 00 01
01 01 01 01 01 00 03 01 02 01 02 01 02 00 00 19
01 00 00 00 00 00 00 00 00 00 00 00 00 00 00 18
01 01 01 01 01 15 03 01 02 01 02 01 02 01 00 17
01 00 00 00 00 00 00 00 00 00 00 01 14 11 00 19
01 00 00 00 00 00 00 00 00 00 00 00 00 00 00 18
01 00 00 00 00 00 00 00 00 00 00 00 00 00 00 17
01 00 00 00 00 00 00 00 00 00 00 00 00 00 00 19
01 00 00 00 00 00 00 00 00 00 00 00 00 00 00 18
01 00 00 00 04 00 00 00 00 00 00 00 00 00 00 17
01 00 00 00 03 00 00 00 00 00 00 00 00 00 00 19
01 00 00 00 02 00 00 00 00 00 00 00 00 00 00 18
01 00 00 00 01 00 00 00 00 00 00 00 00 00 00 17
01 02 05 06 05 06 07 08 09 03 03 02 03 03 15 16 