01 02 03 04 05 06 07 08 09 10 11 12 13 14 15 16 16
01 00 00 00 00 00 00 00 00 00 00 00 00 00 00 00 01
01 00 00 00 00 00 00 22 00 00 00 00 00 00 00 00 01
01 00 00 00 00 00 00 00 00 00 00 00 00 00 00 00 01
01 00 00 00 00 00 00 00 00 00 00 00 00 00 00 00 01
01 00 00 00 00 00 00 00 00 00 11 11 17 11 11 00 01
01 00 17 00 00 00 00 00 00 00 11 00 00 00 11 00 01
01 00 00 00 00 00 00 00 00 00 17 00 00 00 17 00 01
01 00 00 00 00 00 00 00 00 00 11 00 00 00 11 00 01
01 00 00 00 00 00 00 00 00 00 11 11 17 11 11 00 01
01 00 00 00 00 00 00 00 00 00 00 00 00 00 00 00 01
01 00 00 00 00 00 00 00 00 00 00 00 00 00 00 00 01
01 00 00 00 00 00 00 00 00 00 00 00 00 00 00 00 01
01 00 00 00 00 00 00 00 00 00 00 00 00 00 00 00 01
01 00 00 00 00 00 00 00 00 00 00 00 00 00 00 00 01
01 00 00 00 00 00 00 00 00 00 00 00 00 00 00 00 01
01 00 00 00 00 00 00 00 00 00 00 00 00 00 00 00 01
01 00 00 00 00 00 00 00 00 00 00 00 00 00 00 00 01
01 00 00 00 00 00 00 00 00 00 00 00 00 00 00 00 01
01 00 00 00 00 00 00 01 01 01 01 01 00 00 00 00 01
01 00 00 00 00 00 00 00 00 00 00 01 00 00 00 00 01
01 00 00 00 00 00 00 01 01 01 00 01 00 00 00 00 01
01 00 00 00 00 00 00 00 00 01 00 01 00 00 00 00 01
01 00 00 00 00 00 00 00 00 01 00 01 00 00 00 00 01
01 00 00 00 00 00 00 00 00 00 00 00 00 00 00 00 01
01 00 00 00 00 00 00 00 00 00 00 00 00 00 00 00 01
01 00 00 00 00 00 00 00 00 00 00 00 00 00 00 00 01
01 00 00 00 00 00 00 00 00 00 00 00 00 00 00 00 01
01 00 00 00 00 00 00 00 00 00 00 00 00 00 00 00 01
01 01 01 01 01 01 01 01 01 01 01 01 01 01 01 01 01
