01 02 03 04 05 06 07 08 09 10 11 12 13 14 15 16 16
01 00 00 00 00 00 00 00 00 00 00 00 00 00 00 00 01
01 00 00 00 00 00 00 00 00 00 11 11 17 11 11 00 01
01 00 17 00 00 00 00 00 00 00 11 00 00 00 11 00 22
01 00 00 00 00 00 00 00 00 00 17 00 00 00 17 00 21
01 00 00 00 00 00 00 00 00 00 11 00 00 00 11 00 20
01 00 00 00 00 00 00 00 00 00 11 11 17 11 11 00 01
01 00 00 00 00 00 00 00 00 00 00 00 00 00 00 00 01
01 00 00 00 00 00 00 00 00 00 00 00 00 00 00 00 01
01 00 22 00 00 00 22 00 00 00 00 00 00 00 00 00 01
01 00 00 00 02 00 00 00 00 00 00 02 02 00 00 00 01
01 00 00 00 03 00 00 01 02 03 00 01 03 00 00 00 01
01 00 00 00 00 00 00 00 00 00 00 01 01 00 00 00 01
01 01 01 01 01 00 03 01 02 01 02 01 02 00 00 00 19
01 00 00 00 00 00 00 00 00 00 00 00 00 00 00 00 18
01 01 01 01 01 15 03 01 02 01 02 01 02 01 00 00 17
01 00 00 00 22 00 00 00 00 00 00 01 14 11 00 00 19
01 00 00 00 00 00 00 00 00 00 00 00 00 00 00 00 18
01 00 00 22 00 00 00 00 00 00 00 00 00 00 00 00 17
01 00 00 00 00 00 00 00 00 00 00 00 00 00 00 00 19
01 00 00 00 00 00 00 00 00 00 00 02 17 02 00 00 22
01 00 00 00 04 00 00 00 00 00 00 17 00 17 00 00 21
01 00 00 00 03 00 00 00 00 00 00 02 17 02 00 00 20
01 00 00 00 02 00 00 00 00 00 00 00 00 00 00 00 19
01 00 00 00 01 00 00 00 00 00 00 00 00 00 00 00 17
01 02 03 04 05 06 07 08 09 10 11 12 13 14 15 16 16
